222222222222222222222222222222222222222222
211111111111111111111111111111111111111112
211111111111111111111331111111111111111112
200000000000000000000000000000000000000002
200000000000000000000000000000000000000002
200000000000000000000000000000000000000002
200000000000000000000000000000000000000002
200000000000000000000000000000000000000002
200000000000000000000000000000000000000002
200000000000000000000000000000000000000002
200000000000000000000000000000000000000002
300000000000000000000000000000000000000003
300000000000000000000000000000000000000003
200000000000000000000000000000000000000002
200000000000000000000000000000000000000002
200000000000000000000000000000000000000002
200000000000000000000000000000000000000002
200000000000000000000000000000000000000002
200000000000000000000000000000000000000002
200000000000000000000000000000000000000002
200000000000000000000000000000000000000002
200000000000000000000000000000000000000002
222222222222222222222222222222222222222222