111110111111
100000000001
000000000000
100000000001
111110111111